*********************************
.................................
.................................
.................................
.................................
.................................
..............................#..
..............................#..
..............................#..
...#########......#...........#..
...#.......#......#...........#..
...#.......#......#...........#..
...#.......#......#........####..
...#.......#......#........#.....
...#.......#......##########.....
.................................
.................................
*********************************